111111111111
100000000001
1C0000110001
1P0000111E01
100001000101
100001000101
100001000101
100001000101
111111111111
